1111111111
1000000101
1000110001
1001010011
1000011001
1001000101
1010000001
1000000001
1010010001
1111111111