1111111111
1000010101
1010110001
1001010011
1000011101
1001000101
1010000101
1000000001
1010010101
1111111111