1111111111
1000010101
1000110001
1001010011
1000011101
1001000101
1010000001
1000000001
1010010101
1111111111